NO ./assets/wall_fantasy.xpm
SO ./assets/wall_fantasy2.xpm
WE ./assets/wall_fantasy3.xpm
NO ./assets/wall_fantasy3.xpm
EA ./assets/wall_fantasy4.xpm
C 2,11,10
F 65,103,64
111111111111
100000000001
100N00000001
111111111111