NO ./assets/wall_fantasy.xpm
SO ./assets/wall_fantasy2.xpm
WE ./assets/wall_fantasy3.xpm
EA ./assets/wall_fantasy4.xpm
F 65,103,64
C 2,11,83


111111
101011
1100000
100N01
111111
