NO ./texture/brick_256.xpm
SO ./texture/rock_256.xpm
WE ./texture/brick_256.xpm
EA ./texture/rock_256.xpm
C 2,11,10
F 65,103,64
C 2,11,83

11111111111111111
11111111111111111
11111111111111111
11111111111111111