NO ./texture/brick_256.xpm
SO ./texture/rock_256.xpm
WE ./texture/brick_256.xpm
EA ./texture/rock_256.xpm

F 220,100,0
C 225,30,0

       11111111111111 111111
       100000000000000000011
110N00000000001111111111111
1000000000000001
1000001110000001
0000001110000001
100000111 1110001
1000001  0   00001111111111
1111111  0   100000000001
1111111  0   11111111111
