NO ./texture/brick_256.xpm
SO ./texture/brick_256.xpm
WE ./texture/stone_1024.xpm
EA ./texture/rock_256.xpm
F 80, 80, 35
C 0, 128, 255
111111111111111111111111111111111111111111111111111
100000000000100000011100000000000010000000000000011
1101110011001                     11011001011111011
100011001100100111111111000000000111111111000000011
1000010011111001       10000000001        100000001
1100000000000001       10000000001        100000001
1100010000000001       11111000001        100110001
1110111111011111       10000000001        100111001
1110111110000001       1000111111111      100100001
1110111100000001       10000000000 1      100000001
1000001110000001       11111111111 1      111111001
1000001110000001                 1 1      100000001
1W00001110000001                 101      100000001
1111111111111111                  1        111111111
