NO       path_to_the_north_texture 
SO  path_to_the_south_texture          
WE path_to_the_west_texture

EA path_to_the_east_texture
EA path_to_the_east_texturebis

F 220,100,0
C 225,30,0


1 1
101111111111111111111111111
1011000001110000000000001
1001000000000000000000001
11111111101100000111000011111
10000000001100000111011100001
11110111111111011100000000001
11110111111111011101010000001
11000000110101011100000011111
100000000000000011000S001
1000000000000000110101001
1111111111111111111111111