NO       path_to_the_north_texture 
SO  path_to_the_south_texture          
WE path_to_the_west_texture

EA path_to_the_east_texture
EA path_to_the_east_texturebis

F 220,100,0
C 225,30,0


1111111111    11111111111
1110000001    10000000001
1011000001    10000000001
1001000001    10000011111
11111111111111100111
10000000001100000111
11110111111111011100
11110111111111111101
1100000011    111100111111111
1000000001    1011000S00111
1000000001    10110101001
1111111111    11111111111