NO       path_to_the_north_texture 
SO  path_to_the_south_texture          
WE path_to_the_west_texture

EA path_to_the_east_texture
EA path_to_the_east_texturebis

F 220,100,0
C 225,30,0

           1111 1111
111111111111  111 1111111111111
111000000011      1000000000001
101100000111      1000000000001
100100000001      1000000000001
111111111011      1000011100001
100000000011      1000011101111
111101111111      1101110000001
111101111111      1101110101001
110000001101      1101110000001
100000000001      100011000S001
100000000001      1000110101001
111111111111      1111111111111
           11111111