NO       path_to_the_north_texture 
SO  path_to_the_south_texture          
WE path_to_the_west_texture

EA path_to_the_east_texture
EA path_to_the_east_texturebis

F 220,100,0
C 225,30,0

             
111111111    1111111111
100000 01    1000000001
110N00 01   1001111111
111111 0011110001
     1 0000000001
     1 000      1
     1 0000000001
111110 0011111000111111
1 0000 01     1000000001
1       1     1111111111
111111111                