NO ./path_to_the_north_texture
SO ./path_to_the_south_texture
WE ./path_to_the_west_texture
EA ./path_to_the_east_texture

F 220,255,255
C 225,30,0

1111111111111
1000000010011
1000000001111
1000000000001
1110000001101
10000000N0001
1111010000001
1111111111111





