NO ./path_to_the_north_texture
SO ./path_to_the_south_texture
WE ./path_to_the_west_texture
EA ./path_to_the_east_texture

F 220,255,255
C 225,30,0

1111111111111
1001000010011
1000100001111
1100000000001
1110000000101
1000000W00001
1111010000001
1111111111111

