NO ./texture/brick_256.xpm
SO ./texture/rock_256.xpm
WE ./texture/brick_256.xpm
EA ./texture/rock_256.xpm
F 65,103,64
C 2,11,83
 11111
111011
110001
100N01
111111
